{
    "q": "1",
    "w": "2",
    "e": "3",
    "r": "4",
    "t": "5",
    "y": "6",
    "u": "7",
    "i": "8",
    "o": "9",
    "p": "0",
    "a": "@#",
    "s": "#$",
    "d": "$_",
    "f": "_&",
    "g": "&-",
    "h": "-+",
    "j": "+(",
    "k": "()",
    "l": ")/",
    "z": "*",
    "x": "\"",
    "c": "'",
    "v": ":",
    "b": ";",
    "n": "!",
    "m": "?",
    "1": "q",
    "2": "w",
    "3": "e",
    "4": "r",
    "5": "t",
    "6": "y",
    "7": "u",
    "8": "i",
    "9": "o",
    "0": "p",
    "@": "a",
    "#": "as",
    "$": "sd",
    "_": "df",
    "&": "fg",
    "-": "gh",
    "+": "hj",
    "(": "jk",
    ")": "kl",
    "/": "l",
    "*": "z",
    "\"": "x",
    "'": "c",
    ":": "v",
    ";": "b",
    "!": "n",
    "?": "m"
}
